OOOOOOOOOOOOO
OOOOOOOOOOOOO
OOOOOOOOOOOOO
OOOOOOOOOOOOO
OOOOOOBOOOOOO
OWWWWBBBOOOOO
OIOOOOBOOOCCO
OIGIOWWOOOCCO
OIGIOOWOOOCCO
OIGIOOOOOOCCO
OIOIOOOOOOOOO
OOOBBBBBBBOBO
OOBBBBXBBOBOB