SOOOOOSOOOOOS
OOOOOOOOOOOOO
OOOOOOOOOOOOO
OOOOOOOOOOOOO
OOOOOOBOOOOOO
OWWWWBBBOOOOO
O\OOOOBOOOCCO
O/GIOWWOOOCCO
O]GIOOWOOOCCO
O[GIOOOOOOCCO
OIOIOOOOOOOOO
OOOBO546OOOBO
OOBBO1X3OOBOB