SOOOOOSOOOOOS
OOOOOOOOOOOOO
OOGGGOOOOOOOO
OOGGGOOOOOOOO
OOOOOOOOOOOOO
IIIIIIIIIIOII
OBOOIBBOOICIO
OBGBIBIIOOOIO
OBGBOOBIIIIIO
OBGBOOBOOOCCO
OBOBGGGOOOOOO
OOOBO546OBOBO
OOBBO1X3OOBOB