SOOOOOSOOOOOS
OOOOOOOOOOOOO
OOGGGOOOOOOOO
OOGGGOOOOOOOO
OOOOOOBOOOOOO
OBBBBBBBOOOOO
OBOOOBBOOOCCO
OBGBOBBOOOCCO
OBGBOOBOOOCCO
OBGBOOBOOOCCO
OBOBGGGOOOOOO
OOOBGBBBBBOBO
OOBBGBXBBOBOB