OOOOOOOOOOOOO
OOOOOOOOOOOOO
OOOOOOOOOOOOO
OOOOOOOOOOOOO
OOOOOOBOOOOOO
OOOOOBBBOOOOO
OOOOOOBOOOOOO
OOOOOOOOOOOOO
OOOOOOOOOOOOO
OOOOOOOOOOOOO
OOOOOOOOOOOOO
OOOBOBOBOBOBO
OOBOBOBOBOBOB